11111111
1010N001
11110111
1010100
11111100